11
08
...........
....#......
#####..##..
#.#....###.
#.#.######.
#.#........
#....##....
###########