11
08
XXXXXXXXXXX
..X.$$#....
##.XX.$$$..
#$#.X..###.
#^^#.XX.##.
###....$#..
#^......$#.
#^^......$#